6 6 6 6 6 6 6 6 6 6 6 6 6 6 6 6 6 6 6 6 6 6 6 6 6 6 6 6 6 6 6 6 6 6 6 6 6 6 6 6
6 5 5 5 5 5 5 5 5 5 5 5 5 5 5 5 5 5 5 5 5 5 5 5 5 5 5 5 5 5 5 5 5 5 5 5 5 5 5 6
6 5 5 5 5 5 5 5 5 5 5 5 5 5 5 5 5 5 5 5 5 5 5 5 5 5 5 5 5 5 5 5 5 5 5 5 5 5 5 6
6 5 5 5 5 5 5 5 5 5 5 5 5 5 5 5 5 5 5 5 5 5 5 5 5 5 5 5 5 5 5 5 5 5 5 5 5 5 5 6
6 5 5 5 5 5 5 5 5 3 2 3 2 3 2 3 2 3 2 3 4 4 3 2 3 2 5 5 5 5 5 5 5 5 5 5 5 5 5 6
6 5 5 5 5 5 3 2 3 2 3 2 3 2 3 2 3 2 3 2 4 4 4 4 2 3 2 5 5 5 5 5 0 1 0 1 5 5 5 6
6 5 2 3 2 3 2 3 2 3 2 3 2 3 2 3 2 3 2 3 4 4 4 4 4 4 3 2 5 5 5 0 1 0 1 0 5 5 5 6
6 5 3 2 3 2 3 2 3 2 3 2 3 2 3 2 3 2 3 2 3 2 4 4 4 4 2 3 2 5 5 1 0 1 0 1 5 5 5 6
6 5 2 3 2 3 2 3 2 3 2 3 2 3 2 3 2 3 2 3 2 3 2 4 4 4 3 2 3 5 5 0 1 0 1 0 5 5 5 6
6 5 3 2 3 2 3 2 3 2 3 2 3 2 3 2 3 2 3 2 3 2 3 2 4 4 4 3 2 5 5 1 0 7 0 1 5 5 5 6
6 5 2 3 2 3 2 3 2 3 2 3 2 3 2 3 2 3 2 3 2 3 2 3 2 4 4 2 3 2 5 0 1 0 1 0 5 5 5 6
6 5 3 2 3 2 3 2 3 2 3 2 3 2 3 2 4 4 3 2 3 2 3 2 3 2 3 2 3 2 5 1 0 1 0 1 5 5 5 6
6 5 2 3 2 3 2 3 2 3 2 3 2 3 4 4 4 4 4 3 2 3 2 3 2 3 2 3 2 3 5 5 5 5 5 5 5 5 5 6
6 5 3 2 3 2 3 2 3 2 3 2 3 4 4 4 4 4 4 4 3 2 3 2 3 2 3 2 3 2 2 5 5 5 5 5 5 5 5 6
6 5 2 3 2 3 2 3 2 3 2 3 4 4 4 4 4 2 4 4 2 3 2 3 2 3 2 3 2 5 5 5 5 5 5 5 5 5 5 6
6 5 3 2 3 2 3 2 3 2 3 2 3 4 4 4 4 2 3 2 3 2 3 2 3 2 3 5 5 5 5 5 5 5 5 5 5 5 5 6
6 5 2 3 2 3 2 3 2 3 2 3 2 4 4 4 2 3 2 3 2 3 2 3 2 3 2 5 5 5 5 5 5 5 5 5 5 5 5 6
6 5 5 5 5 5 5 5 5 5 5 5 5 4 4 5 5 5 5 5 5 5 5 5 5 5 5 5 5 5 5 5 5 5 5 5 5 5 5 6
6 5 5 5 5 5 5 5 5 5 5 5 5 5 5 5 5 5 5 5 5 5 5 5 5 5 5 5 5 5 5 5 5 5 5 5 5 5 5 6
6 6 6 6 6 6 6 6 6 6 6 6 6 6 6 6 6 6 6 6 6 6 6 6 6 6 6 6 6 6 6 6 6 6 6 6 6 6 6 6
