6 6 6 6 6 6 6 6 6 6 6 6 6 6 6 6 6 6 6 6 6 6 6 6 6 6 6 6 6 6 6 6 6 6 6 6 6 6 6 6
6 5 5 5 5 5 5 5 5 5 5 5 5 5 5 5 5 5 5 5 5 5 4 4 4 4 4 4 4 4 4 4 4 4 4 4 4 4 4 6
6 5 5 5 5 5 5 5 5 5 5 5 5 5 5 5 5 5 5 3 2 3 2 3 2 3 4 4 4 4 4 4 4 4 4 4 4 4 4 6
6 5 5 5 5 5 5 5 5 5 3 2 3 2 3 2 3 2 3 2 3 2 3 2 3 2 3 2 4 4 4 4 4 4 4 4 4 4 4 6
6 5 5 5 5 5 5 3 2 3 2 3 2 3 2 3 2 3 2 3 2 3 2 3 2 3 2 3 2 3 4 4 4 4 4 4 4 4 4 6
6 5 5 5 3 2 3 2 3 2 3 2 3 2 3 2 3 2 3 2 3 2 3 2 3 2 3 2 3 2 3 2 4 4 4 4 4 4 4 6
6 5 2 3 2 3 2 3 2 3 2 3 2 3 2 3 2 3 6 6 6 6 6 3 2 3 2 3 2 3 2 3 2 3 2 4 4 4 4 6
6 5 0 1 0 1 0 2 3 2 3 2 3 2 3 2 3 6 6 4 4 4 6 6 3 2 3 2 3 2 3 2 3 2 3 4 4 4 4 6
6 5 1 0 1 0 1 0 2 3 2 3 2 3 2 3 6 6 4 4 4 4 4 6 2 3 2 3 2 3 2 3 2 3 2 4 4 4 4 6
6 5 0 1 0 1 0 1 3 2 3 2 3 2 3 2 6 4 4 4 4 4 4 2 3 2 3 2 3 2 3 2 3 2 3 4 4 4 4 6
6 5 1 0 7 0 1 0 2 3 2 3 2 3 2 3 6 6 4 4 4 4 4 3 2 3 2 3 2 3 2 3 2 4 4 4 4 4 4 6
6 5 0 1 0 1 0 1 0 2 3 2 3 2 3 2 3 6 4 4 4 4 4 2 3 2 3 2 3 2 3 2 3 2 4 4 4 4 4 6
6 5 1 0 1 0 1 0 2 3 2 3 2 3 2 3 2 6 6 4 4 4 4 6 6 3 2 3 2 3 2 3 2 3 2 4 4 4 4 6
6 5 0 1 0 1 0 2 3 2 3 2 3 2 3 2 3 2 6 6 6 6 6 6 3 2 3 2 3 2 3 2 3 2 3 2 3 4 4 6
6 5 5 5 5 0 2 3 2 3 2 3 2 3 2 3 2 3 2 6 2 3 2 3 2 3 2 3 2 3 2 3 2 3 2 3 4 4 4 6
6 5 5 5 3 2 3 2 3 2 3 2 3 2 3 2 3 2 3 2 3 2 3 2 3 2 3 2 3 2 3 2 3 2 3 4 4 4 4 6
6 5 5 5 5 3 2 3 2 3 2 3 2 3 2 3 2 3 2 3 2 3 2 3 2 3 2 3 2 3 2 3 2 4 4 4 4 4 4 6
6 5 5 5 5 5 5 5 3 2 3 2 3 2 3 2 3 2 3 2 3 2 3 2 3 2 3 2 3 2 3 4 4 4 4 4 4 4 4 6
6 5 5 5 5 5 5 5 5 5 5 5 5 5 5 5 5 5 5 5 5 5 5 5 5 5 5 4 4 4 4 4 4 4 4 4 4 4 4 6
6 6 6 6 6 6 6 6 6 6 6 6 6 6 6 6 6 6 6 6 6 6 6 6 6 6 6 6 6 6 6 6 6 6 6 6 6 6 6 6
